################################
###            ##            ###
### #### ##### ## ##### #### ###
### #### ##### ## ##### #### ###
### #### ##### ## ##### #### ###
###                          ###
### #### ## ######## ## #### ###
### #### ## ######## ## #### ###
###      ##    ##    ##      ###
######## ##### ## ##### ########
######## ##### ## ##### ########
######## ##          ## ########
######## ## ######## ## ########
######## ## ######## ## ########
X           ########           X
######## ## ######## ## ########
######## ## ######## ## ########
######## ##          ## ########
######## ## ######## ## ########
######## ## ######## ## ########
###            ##            ###
### #### ##### ## ##### #### ###
### #### ##### ## ##### #### ###
###   ##.......         ##   ###
##### ## ## ######## ## ## #####
##### ## ## ######## ## ## #####
###      ##    ##    ##      ###
### ########## ## ########## ###
### ########## ## ########## ###
###                          ###
################################